********
** V ***
*  *   *
* * *  *
*  *   *
*    * *
* O    *
********