****************
** *      ** * *
* *  ** **     *
*   *       ** *
* ** **    *   *
*  * *  * *V ***
**    **** *   *
**     * *  ** *
*  *     *  ** *
*  * *    *  * *
*      *  *    *
* *   **      **
** **** **  * **
** * ***       *
*O         *   *
****************